13 20
24 00
20
0000000000000000000000000
0000000000000000000001000
0000000100000000000000000
0000000000000001000000000
0000000000000000000100000
0000000000000000000000000
0000000000000000000000000
0001000000100010000000000
0000000000000000000000000
0000000000100000000100000
0001000000000000000000000
0000000100000000000000000
0000000000000010000001000
0001000000000000000000000
0000000100000000001000000
0000000000001000000000100
0000000000000000000000000
0000000000000000000000000
0000100100100001010100000
0000000000001000000000000
0000110010000000000000000
0000000000000000000000100
0000000000001000101000100
0000000000000000000000100
0000000101000010000000100