13 20
24 00
26
0000000000111110000000000
0000000000000010000001000
0001111110000010000000000
0000111111000101000000000
0010101111000100000100000
0001100000000100000000000
0000001000011101111100000
0001000110100010000000000
0000000010000000000000000
0000000010100000000100000
0001000010000000000000000
0000000110000000000000000
0000000000100010000001000
0001000000001000000000000
0000000100000010001000000
0000000000001000100000100
0000000000000000000000000
0000000001111000001100000
0000100100100001010100000
0000000000001000000000000
0000110010000000000000000
0000000000000000000000100
0000000000001000101000100
0000000000000000000000100
0000000101000010000000100