13 20
12 05
00
0000000001111110000000000
0000000110000001100000000
0000011000000000011000000
0000100011000011000100000
0001000000000000000010000
0001000000000000000010000
0001000000000000000010000
0001001100000000110010000
0001000011000011000010000
0000100000111100000100000
0000011000000000011000000
0000000110000001100000000
0000000001111110000000000
0000000000000000000000000
0000000000000000000000000
0000000000000000000000000
0000000000000000000000000
0000000000000000000000000
0000000000000000000000000
0000000000000000000000000
0000000000000000000000000
0000000000000000000000000
0000000000000000000000000
0000000000000000000000000
0000000000000000000000000